%%%%%%%%%%%%%%%%%%%%%%
%                    %
%    B               %
%                    %
%          %      B  %
%                    %
%                    %
%        %           %
%                   $%
%           R      $E%
%%%%%%%%%%%%%%%%%%%%%%
