%%%%%%%%%%%%%%%%%%%%%%
%    $$              %
%   $BE$             %
%    $$              %
%          %         %
%                    %
%                    %
%        %           %
%                   $%
%           R      $E%
%%%%%%%%%%%%%%%%%%%%%%
