%%%%%%%%%%%%%%%%%%%%%%
%    $$              %
%   $B $             %
%    $$          B   %
%                    %
%                    %
%                    %
%                    %
%                   $%
%           R      $E%
%%%%%%%%%%%%%%%%%%%%%%