%%%%%%%%%%%%%%%%%%%%%%
%    %$              %
%   %B%              %
%    %$              %
%                    %
%                    %
%                    %
%                    %
%                   $%
%                  $E%
%%%%%%%%%%%%%%%%%%%%%%