%%%%%%%%%%%%%%%%%%%%%%
%    $$              %
%   $B $             %
%    $$              %
%                    %
%                    %
%                    %
%                    %
%                   $%
%           R      $E%
%%%%%%%%%%%%%%%%%%%%%%