%%%%%%%%%%%%%%%%%%%%%%
%B%         R        %
%%                $  %
%          $$$$$$$$  %
%$$$$$$$$         $R %
%                 $  %
%   $$$$$$$$$        %
%                    %
%  R        $$$$$$$  %
%   $$$$$$$$$        %
%%%%%%%%%%%%%%%%%%%%%%
